Product_Category,Revenue,Cost,Margin,Units_Sold,Rating
Electronics,85000,60000,25000,500,4.2
Clothing,65000,45000,20000,800,3.8
Books,35000,25000,10000,1200,4.5
Home & Garden,55000,40000,15000,300,4.1
Sports,45000,32000,13000,400,4.3
Toys,30000,22000,8000,600,4.0
Automotive,75000,55000,20000,200,4.4
Health & Beauty,40000,28000,12000,350,3.9
Food & Beverage,60000,42000,18000,450,4.2
Furniture,70000,50000,20000,150,4.6
